+++++++++++++T+++++++++++++++++++++++++++++++
++++++++T++++++++T+++++++++++++++++++++++++++
++++T+++++++++++++++++T++++++++++++++++++++++
+++++++++T+++rrrrrrr+++++++++++++++++++++++++
+++++++++++rr+++++++rr+++T+++++++++++++++++++
++++++T++rr+++++++++++rr+++++++++++++++++++++
++++++++r+++++++++++++++r+++++++T++++++++++++
+++T++++r+++++++++++++++r++++T+++++T+++++++++
+++++++r+++++++++++++++++r+++++++++++++++++++
+++++++r+++++++++++++++++r++T+++++T++T+++++++
++++++r+++++++++++++++++++rrrrrrrrrrrrrrrrrrr
++T+++r++++++++r+r++++++++++++++++++E++++++++
++++++r++++++++rrr++++++++++++++++++E++++++++
++T+++r++++S++rrMrr+++++++++++++++++E++++++++
+rrr++r++++++++rrr++++++++++++++++++E+M++++++
++++++r+++++++++r+++++++++++++++++++E++++++++
++T+++r+++++++++++++++++++rrrrrrrrrrrrrrrrrrr
+++++++r+++++++++++++++++r+++++++++++++++++++
+++++++r+++++++++++++++++r++++T++++++++T+++++
+T++++++r+++++++++++++++r+++++++++++T++++++++
+++++T++r+++++++++++++++r+++++++T+T++++++++++
+++++++++rr+++++++++++rr+++++++++++++++++++++
++++++T++++rr+++++++rr+++T+++++++++++++++++++
++++T++++++++rrrrrrr+++++++++++++++++++++++++
+++++++++T+++++++++T+++T+++++++++++++++++++++
+T++++T+++++++++T+++++++T++++++++++++++++++++
+++++++++++T++++++++T++++++++++++++++++++++++