rrrrrrrrrrrrrrrr++rrrrrrrrrrrrr++rrrrrr+++++++++++
r++++++++++++++++++++++++++++++++++++++T++++++++++
r+++++++++++++++R++++++++++++++R++++++++T+++++++++
r++++++++1++++++r+++++++1++++++r+++++++++T++++++++
r+++++++++++++++++++++++++++++++++++++++++T+++++++
r++++++++++++++++++++++++++++++++++++++++++T++++++
r+S+++++rrr+++++1++++++rrr+++++1++++++++++++T+++++
r++++++++++++++++++++++++++++++++++++++++++++T++++
r+++++++++++++++++++++++++++++++++++++++++++++T+++
r++++++++1++++++r+++++++1++++++r+++++++++++++++T++
r+++++++++++++++++++++++++++++++++++++++++++++++T+
r+++++++++++++++R++++++++++++++R+++++++++++++++++T
rrrrrrrrrrrrrrrr++rrrrrrrrrrrrr++rrrrrrr+++++++++r
+++++++++++++++++++++++++++++++++++++++r+++++++++r
+++++++++++++++++++++++++++++++++++++++r+1+++++1+r
+++++++++++++++++++++++++++++++++++++++r+++++++++r
+++++++++++++++++++++++++++++++++++++++r+++++++++r
+++++++++++++++++++++++++++++++++++++++r+++++++++r
+++++++++++++++++++++++++++++++++++++++r+++++++++r
+++++++++++++++++++++++++++++++++++++++r++++1++++r
+++++++++++++++++++++++++++++++++++++++r+++++++++r
+++++++++++++++++++++++++++++++++++++++r+++++++++r
+++++++++++++++++++++++++++++++++++++++r+++++++++r
+++++++++++++++++++++++++++++++++++++++r+++++++++r
+++++++++++++++++++++++++++++++++++++++r+1+++++1+r
+++++++++++++++++++++++++++++++++++++++r+++++++++r
++++++rrrrrrrrrr++rrrrrrrrrrrrr++rrrrrrr+++++++++r
+++++r+++++++++++++++++++++++++++++++++++++++++++T
++++r+++++++++++R++++++++++++++R++++++++++++++++T+
+++r+++++1++++++r+++++++1++++++r+++++++++++++++T++
rrrr++++++++++++++++++++++++++++++++++++++++++T+++
+++E+++++++++++++++++++++++++++++++++++++++++T++++
++M+E+++rrr+++++1++++++rrr+++++1++++++++++++T+++++
+++E+++++++++++++++++++++++++++++++++++++++T++++++
rrrr++++++++++++++++++++++++++++++++++++++T+++++++
+++r+++++1++++++r+++++++1++++++r+++++++++T++++++++
++++r+++++++++++++++++++++++++++++++++++T+++++++++
+++++r++++++++++R++++++++++++++R+++++++T++++++++++
++++++rrrrrrrrrr++rrrrrrrrrrrrr++rrrrrr+++++++++++