+++++++++++++++++++T++++++++++++++++++++++++T+++++++++++++++++
++++++++++++++T++++++++T++++++++++T+++++++++++++++++++++++++++
++++++++++T+++++++++++++++++T+++++++++++T+++++++++++++++++++++
++++++rrrrrrrrrrrrrrrr++rrrrrrrrrrrrr++rrrrrr+++++++++++++++++
++++++r+++++++++++++++++++++++O++++++++++++++T++++++++++++++++
++++++r+++++++++++++++R+++++++O++++++R++++++++T+++++++++++++++
++++++r++++++++1++++++r+++++++O++++++r+++++++++T++r+++++++++++
++++++r+++++++++++++++++++++++O+++++++++++++++++T++++T++++++++
++++++r+++M+++++++++++++++++++O++++++++++++++++++T++++++++++++
++++++r+S+++++rrr+++++1++++++rrr+++++1++++++++++++T+++T+++++++
++++++r++++++++O+++++++++++++++++++++++++++++++++++T++++++++++
++++++r++++++++O++++++++++++++++++++++++++++++++++++T+++++++++
++++++r++++++++O++++++r+++++++1++++++r+++++++++++++++T++++++++
++++++r++++++++O++++++++++++++++++++++++++++++++++++++T+++++++
++++++r++++++++O++++++R++++++++++++++R+++++++++++++++++T++++++
++++++rrrrrrrrrrrrrrrr++rrrrrrrrrrrrr++rrrrrrr+++++++++r++++++
+++++++++++++++++++++++++++++++++++++++++++++r+++++++++r++++++
+++++++++++++++++++++++++++++++++++++++++++++r+1+++++1+r++++++
+++++++++++++++++++++++++++++++++++++++++++++r+++++++++r++++++
+++++++++++++++++++++++++++++++++++++++++++++r+++++++++r++++++
+++++++++++++++++++++++++++++++++++++++++++++r+++++++++r++++++
+++++++++++++++++++++++++++++++++++++++++++++r+++++++++r++++++
+++++++++++++++++++++++++++++++++++++++++++++r++++1++++r++++++
+++++++++++++++++++++++++++++++++++++++++++++r+++++++++r++++++
+++++++++++++++++++++++++++++++++++++++++++++r+++++++++r++++++
+++++++++++++++++++++++++++++++++++++++++++++r+++++++++r++++++
+++++++++++++++++++++++++++++++++++++++++++++r+++++++++r++++++
+++++++++++++++++++++++++++++++++++++++++++++r+1+++++1+r++++++
+++++++++++++++++++++++++++++++++++++++++++++r+++++++++r++++++
++++++++++++rrrrrrrrrr++rrrrrrrrrrrrr++rrrrrrr+++++++++r++++++
+++++++++++r++++O++++++++++++++++++++++++++++++++++++++T++++++
++++++++++r+++++O+++++R++++++++++++++R++++++++++++++++T+++++++
+++++++++r+++++1O+++++r+++++++1++++++++++++++++++++++T++++++++
rrrrrrrrrr++++++O++++++++++++++++++++R++++++++++++++T+++++++++
+++++++++E++++++O++++++++++++++++++++OO++++++++++++T++++++++++
++++++++M+E+++rrr+++++1++++++rrr+++++OO+++++++++++T+++++++++++
+++++++++E++++++O++++++++++++++++++++OO++++++++++T++++++++++++
rrrrrrrrrr++++++O+++++++++++++++++++++++++++++++T++++r++++++++
+++++++++r+++++1O+++++r+++++++1++++++R+++++++++T++++++++++++++
++++++++++r+++++O+++++++++++++++++++++++++++++T+++++++++++++++
+++++++++++r++++O+++++R++++++++++++++R+++++++T++++++++++++++++
++++++++++++rrrrrrrrrr++rrrrrrrrrrrrr++rrrrrr+++++rR++++++++++
+++++++++++++++++++T++++++++++++++++++++++++T+++++++++++++++++
++++++++++++++T++++++++T++++++++++T+++++++++++++++++++++++++++
++++++++++T+++++++++++++++++T+++++++++++T+++++++++++++++++++++